ल११जायद्धया

३५3

लेखक : श्री न्चत्माका मत्तक्ररी '
अनुवाद : प्रतिभा मत्तकरी
मुखिया : नीरज सूद
मास्टर/सरपंच, मुंडा/हवलदार : मुनीष मोहन

जगनियां ' : सुरेश शर्मा
सावित्रि : सीमा शर्मा
बसंती व मुलगी : सपना द्विवेदी
सठजी बाली व बसंती की मां : दक्षा
पाटिल दृ नरेश मस्ताना
फौजदार ' ‘1 तिलक
पत्रकांरश्व ठेकेदार : पुष्पराज एवं गगन ‘

सठजीवालां व गुच्छा : इन्दरपाल
झार्मपेया : हेमन्त

.

पाटिल का भतीजा व मुकादम : पंकज

सब्जी वाला ग्रामवासी व गायक : मंजु,
दोस्त व इंसपेक्टर : महेश

रुहानू : अविनाश

गुण्डा : गगन, प्ररित, इन्दरयाल, हेमन्त व" मंजू
ग्रामवासी : सभी कलाकार

मंच परे :
निर्देशक : प्रतिभा मत्तकरी

वेषभूषा: प्रतिभा मत्तकरी .

.

.

~

,

संगीत : इन्दरपाल व मंजू -

प्रकाश : सुरेश शर्मा

