दृब्रककॉडी - गोल अग्रवाल

म्नट्टाबीदृ - प्रदीप रतेरिया
लीव्रदृअंड़ - प्रदोष अरोडा

श्लो-ड़शी - विनीता रैलिन
तादाढ़रस - सुंबल घोष : दीपक गुप्ता

व्रछिदृडद्देदृ - रामअवतार बागला

हक्लधेक्टदृ - राजेन्द्र भाटिया : रबि दवे
खाक्टदृ - दीपक गुप्ता

रानो जो आं … प्रतिमा अग्रवाल
बुखारी - प्रदीप मरसिया

में ब्लार्द्धब्र क्य-गौपाल कलवानोहोरालाल
सर्वेश्वर' शिदोभहिं — नरेन्द्र अग्रवाल
आदित्य बिक्रम
रामगोपाल बागला
रुआंढ़मी है - सुरेश
ख्याड़ओ a - केदार अग्रवाल

.
होम - सुस्मिता सिधी
द्धांका-मोनाक्षी साह : पुनीत अग्रवाल
निर्मल - रामअवतार बमृगला
क्यों श्रेस्वी - वादेता साह
.
फकौदृ - रवि दबे : आदित्य विक्रम -

खाणा - राजेन्द्र भाटिया : दीपक गुप्ता
विकिं - प्रदीप रतेरिया
आवो - हीरालाल

आडीबान्न - रामगोपाल बागला

8, बिशप लेफोंय रोड,
कल कता - २ ०

‘ फोन : ४४-४ : र ९

८

