TAGORE IN MAITHILI THEATRE
MA I L0 RAN G
-.हु'ँहै..ं हैड्ड'ग्नट्वेंदुदृ८ ,दृ दुनु.

3माचं 2012 - रवीन्द्र अर्पण

जल डमरू बाजे
समय : 7.00 बजे, एल-फी-त्रि, मगडी हाउस, नईं दिछी

प्रस्तुति : पीत्वा-रेंग रेपर्टरी ( दिल्ली )
लेखक : दृइडेट्टव्रर है é}: ’

अदुबड्डद : ah ड्डेक्ष्यदृड्ड awn-2?: एवं दृष्टकाड्डड्डा झंड
ईहैंदेंङ्कदेंमृ : व्रक्राट्टमृइ झा
यात्र - परिचय :

संगीत : अनिल मिश्र, निलेश, संतोष,

भुखला : मुकेश झा
भुखली : स्वपना मिश्रा

रमेश मल्लिक, राजेश सिह
गीत : राकेश मिश्रा
ध्वनि संयोजन एवं संचालन : राजीव मिश्र

सुंप्पी : अनिल मिश्र
प्रकाश : उत्पल झा

रामकली : ज्योति झा
वस्त्र : ज्योति, पुष्पा, नेहा

खोया : संतोष कुमार / प्रवीण कुमार
पेका-अप : मुकेश झा, दीपक ठाकुर

गहना : पुष्पा झा
रामभरोसे : नीस्नेश दीपक

मुँहचीरा : दुर्गेश चौधरी / संतोष कुमार

मंच सामग्री : राकेश मिश्र, संतोष कुमार
प्रचार-प्रसार : गौतम, कमलेश
संहयोग : राधाकांत, ऋषि श, मुरारी
मंच परिकल्पना : प्रकाश श, मुकेश झा

कबूतरी : नेहा वर्मा
प्रवृति संहायक : नीरा कुमारी, सुधा झा,

प्यरि : राजीव रंजन / भाष्कर झा

नेता : दीपक ठाकुर / भाष्कर झा

दीपक ठाकुर
प्रस्तुति नियंत्रण : मुकेश झा

