नेपथ्य
सहायक निर्देशक और मंच-व्यवस्थापक : जयन्त देशमुख
सहायक मंच- व्यवस्थापक : आमोद कृष्ण भट्ट
मंच- परिकल्पना : राम रहमान

मंच सहायक : अनूप जोशी/गणेश चौरसिया
सहायक व निर्माण : काजी/लीप/विकी/रामावतार
_ मंच- सामग्री : अमर सिंह/अनिता हुये
वेशभूषा : विभा मिश्र
वेशभूषा- सहायक : हेमलता महावर/रबिलाल सांगड़े
वार्डरोब : नारायणराव दीक्षित
सिलाई : अशोक अहिरवार
रूप-सज्जा : उमेश तरकसबार/सुभाश्री भट्ट
अकाश-परिकल्पना : एमके. रैना

प्रकाश-संचालन/सहायक : आशुतोष पगद्धूया/गोपाल दुबे
ध्वनि संकलन : आमोद कृष्ण भट्ट
सहयोग : लियाक्रत

ध्वनि संचालन : जयन्त देशमुख/ख्याल कुमार जैम
तकनीकी सहायक : रघुबीर होलना/रमशदृर्युश/बयलेज्ञा फारूख
पूर्वाभ्यास व्यवस्था : गोविन्द दीक्षित
प्रेक्षागृह व्यवस्था : द्वारिका प्रसाद/हसन हैदर
प्रचार-प्रसार, प्रदर्शनी : बीना सिह/कमल जैन/धूपेन्द्र साहू
डाक्यूमेन्टेशन : संजय गो-हता/मरोज शर्मा
सहयोग : मनोज चतुर्वेदी/इन्द्रमणि मिश्र
छायांकन : विजय रोहतगी
वीडियो : प्रताप सिंह सैनी
मसिंया : महाकवि पोर अनीस

पोस्टर आकल्पन : राम रहमान/हिमांशु जोशी
प्रस्तुति व्यवस्थापक : जावेद जैदी
प्रशासनिक सहयोग : रामवीर शर्मा/प्रमोद श्रीवास्तव
नाट्य आलेख : राजेश जोशी
परिकल्पना एवं निर्देशन : एनके. रैना

स्मारिका सम्पादन एवं प्रकाशन : मदन सोपी/ग्रेमाक्रिर शुक्ल
आभार : बलराज मेनरा, शरद दत्त, देवेन्द्र इस्सर, रूप किशोर पंडूया,
आकाशवाणी, दूरदर्शन भोपाल.

