मुंशी : जैकी सुरेन्द्र कौड़।

अप्सरा : नगीन तनबीर

जल्लाद : गोविन्द राम, रामचन्द्र

. बादल : चैत राम

गोया अपराधी : चैतराम

फिरत्: भुलाना राम

जेलर : रामचन्द्र

_

बैद जी : रामचरण

''

बिसरु : रामचरण

.

गुलामों झा सौदागर : बृजलाल
अधि कैदी : उदय, गोविन्द, शिव दयाल, गोपाल

याधूगण : जोगी, रौकी, सुरेन्दर, रामचन्द्र, सद्दीक्र, उदय,
सज, गोपाल, बदरु राम, मबैल, कावेराम
-

गुलाम :
बिजली : पूनम सोनबानी
मंगली : आगेश भरकम
अंगूरी : श्यत्मा भरकम

मृत बच्चे के साथ औरत : चैतराम,
चाण्डाल : रामचरण, भूलता राम
झन्डे वाले : रामचन्द्र, शिब दयाल, सज, चैतराम
दुखी लोग : गोविन्द, वासनिक
I

रामी : भाला सोनवानी

मरता हुआ आदमी : बचन पछेरा

मंच पार्श्व

'

वस्त्र सज्जा : अर्चना बर्मा ३

गीत : हबीब तनबीर

सामग्री : राकेश भारद्वाज

संगीत : देवीलाल तथा हबीब तनबीर

सुरेन्द्र यज्ञा

प्रकाश : गिरधारी

सहायक : लवलीन मिश्रा, आगेंश मरकम, उदय राम,

मंच व्यवस्था : मोनिका मिश्रा तनबीर

बृजलाल, भूलता राम

,

गृह व्यवस्था : आलोक माथुर, आशुतोष उपाध्याय

_

हेमन्त मिश्रा, जानम

हंस : दादी पाम जी
निदेशक

हबीब तनबीर

