नेपथ्य
सहायक निर्देशक और मंच-व्यवस्थापक : जयन्त देशमुख
सहायक मंच- व्यवस्थापक : आमोद कृष्ण भट्ट
मंच- परिकल्पना : राम रहमान

मंच सहायक : अनूप जोशी/गणेश चौरसिया
सहायक व निर्माण : वाजी/तलघर/मिल/रामावतार
मंच- सामग्री : अमर सिंह/अनिता दुबे
वेशभूषा : विभा मिश्र

वेशभूषा- सहायक : हेमलता महावंर/रविलाल सांगडे
वार्डरोब : नारायणराव दीक्षित

सिलाई : अशोक अहिरवार
रूप-सज्जा : उमेश तरकसवार/सुभाश्री भट्ट
अकाश-परिकल्पना : एमके. रैना
प्रकाश-संचालन/पायल : आशुतोष यण्डप/गोयाल हुये
ध्वनि संकलन : आमोद कृष्ण भट्ट
सहयोग : लियाकत

ध्वनि संचालन : जयन्त देशमुख/ख्याल कुमार जैन
तकनीकी सहायक : रघुबीर होल्ला/रामबप्यू/सुरेश/कमलेश/फारूख
पूर्वाभ्यास व्यवस्था : गोविन्द दीक्षित
प्रेक्षागृह व्यवस्था : द्वारिका प्रसाद/हसन हैदर

प्रचार-प्रसार, प्रदर्शनी : मीना मिह/ख्याल जैन/धूपेन्द्र साहू
डाक्यूमेन्टेशन : संजय गो-हता/सरोज शर्मा

सहयोग : मनोज चतुर्वेदी/इन्द्रमणि मिध
छायांकन : विजय रोहतगी
वीडियो : प्रताप सिंह सैनी
मसिंया : महाकवि मीर अनीस

पोस्टर आकल्पन : राय रहमान/हिमांशु जोशी
प्रस्तुति व्यवस्थापक : जावेद जैदी
प्रशासनिक सहयोग : रामवीर शर्मा/प्रपोद श्रीवास्तव
नाट्य आलेख : राजेश जोशी

परिकल्पना एवं निर्देशन : WI
स्मारिका सम्पादन एवं प्रकाशन : मदन सोनी/प्रेमशंकर शुक्ल
आभार : बलराज मेनरा, शरद दत्त, देवेन्द्र इस्सर, रूप किशोर पंल्लूया,
आकाशवाणी, दूरदर्शन भोपाल.

