मंच पर
गोमती : सीमा श्रीवास्तव
विरमा : दिनेश खन्ना
कुरुनू : ऋचा डग
इजा : नलिनी
कलियंका : प्रकाश भाटिया
तेजराम : संजीव वत्स

देवराम : सुवर्ण रावत
खिमुका : राज किशोर
पत्नी : सन्तोष लता
लड़की : वर्षा अग्निहोत्री
पटवारी : जगमोहन

मुँशी : इन्द्रजीत कनौजिया
पत्तरौल : डी ० एल ० सिंह

यांबू : विजय गुप्त'
पटवारी का करिन्दा : राजेश
थोकदार : पंकज

धोडिया डाक्टर : नरेश तलवार
थानेदार : किशन रावत
सिपाही, मुँशी z करीम खान
९हुंशहाल : राकेश ठाकुर

पात्र -परिचय
खुशहाल की औरतें : निशी सिंह तथा
रचना मलिक
लाला तिरपन लाल : ए ० के ० कविराज

नाविक : गुरबचन सिंह
लछरैंन गाँव के लोग : रमेश, सुनील,
विजय गुप्ता, दिनेश
फॉर्म के कामगार : राज किशोर,
जगमोहन, इन्द्रजीत, डी० एल० सिंह,
विजय, राजेश, पंकज, नरेश, किशन,
रमेश आदि

नेपथ्य में
भूल उपन्यास : हिमांशु जोशी
नाट्य-रूपान्तर : दिनेश खन्ना
मंच-व्यवस्था : प्रकाश भाटिया,
संजीव वत्स
प्रकाश परिकल्पना : जे ० पी ० सिंह
वेशभूषा : नलिनी कमल, रचना

संच-सामग्री एवं प्रस्तुति नियन्द्रण :
विजय गुप्ता, राकेश डग
संगीत : पीयूष मिश्रा

