गायों - परिचय
मंच पर

राम we (नौकर) : हीमाँबु
सपना (युवती) : ममता माथुर

आना-ब (पृस्मपना के पिता) : दीपक पारीक
दादाजी : कुलदीप माथुर

वहीं खुआ (लीलावती)

: उषा नागा

छोटी बुआ (वन्दना) : मीनाक्षी नय्यर
युवक (अनिल) : राहुल त्रिवेदी
मिका-एक : दीपक पारीक

मित्र-दौ : राकेश स्वेन

मंच यारों
संगीत एवं ध्वनि प्र-मब : राकेश सैन
पकाया व्यवस्था : कुलदीप माथुर, आसु शर्मा
मंच व्यवस्था : दीपक पारीक

दृश्य अंध : दीपक गुप्ता

वेशभूषा : राहुल त्रिवदी
रूप सज्जा : विन्दु भटनागर
निर्देशक : सरताज माथुर
सहायक निर्देशक : राकेश सैन
लेखक : हभीदुल्लऱ
संयोजक : प्रतापसिंह चौधरी

कूल सदस्यों की संरव्या

पुरुष
मडित्का

18

14
:

4

नाटक कनै अवधि : एक घंटा बीख मिनट

