अभिनय छात्र
हेमांग व्यास : अर्सेन कज़बेकी-एक सोता राजकूमार

अशोक धर्मसोत : शलवा-एक फहराया, आयरनसर्ट
अमिता शर्मा : नाटेला-गवर्नर दो पत्नी, इनवैलिड
सुनील सोनी : जॉर्जी (ममफतवे-ती-श-गव-रि, अफ़सर, सराय का मालिक

पूर्णिमा येँत्रकोक्मम, वंदना रावत, मंगल सनप, लैण्डियांग सियम, भाषा सुम्बली :
एसा वास्नऱदृजे-रसोईंघर दो नौकरानी

विनोद चवन : साइमन शाशावा
काचू अहमद बन : अज़दक-गांव का अमिलेरव्रक, वास्तुकार

लाख्या लेजा : माइकल-गवर्नर का देता
मुक्ति दास : गायक, भिक्षु
सोनमणि शर्मा : राजधानी से आया दूत, शौवा-एक पुलिसकमी
गुरिंदर कुमार : दूध वाला बूढा किसान, जैसा, प्राइवेट, भतीजा
ववालु गुप्ता : लर्थिरे९ती वारनादृजे-जूसा का भाई, आयरनसर्ट

विनोद चवन : साइमन शाशावा
अनुपम दत्ता : ग्रैंड ड्यूक, लंगडा सादगी
: निको मिकादृजे व मिका लोलादृजै-डॉक्टर
लैण्डियांग सियम, भाषा

: इलो शुबोलादृऱत्ते व साद्रो ओंबलादृऱज्ञे-वकील
जंगल सनप, पूर्णिमा
पूपिन्धि येंत्रकोवपम, वंदना रावत, लैण्डियांग सियम : तीन धनी किसान
भाषा सुम्बली : अनिको, त्नात्रि१ती की पत्नी
मंगल सनप : गरीब बूढी किसान औरत

यशवंत : सैनिक

परिकल्पना छात्र
कनन्तुनि : दृश्य व पस्त्ररमृष्णा / किसान, डॉक्टर
संगीत श्रीवास्तव : दृश्य व वस्त्ररनज्जा
सायंत्ती साहू : पोस्टर व ब्रोशर, मंचसामग्री/नीना, किसान दो पत्नी

जगदीश आर : मंचसामग्री व गायकों के गीतों का संयोजन
अलियार जो : ध्वनि परिकल्पना व मंच व्यवस्थक्च/इरावली दस्यु

अर्पिता धागत व प्रियंका पाठक : प्रकाश परिकल्पना
मालविका राव : मंच सामग्री

अतिधि कलाकार
मुकंश आ, हेमंत पाल, विजय शर्मा, विजय कुमार, मनीषा पटेल, नीलम साही, मुनेन्द्र कुमार, राजा
रैवचाड़, करुणाकर दुबे : सैनिक, नौकर, किसान, भिखारी, संगीतकार

