Cast
Lengshonnel: Binaswori Devi
Guirenei: Ushakiran
Khullakpi: Meerabai
Soibenpu: Premananda
Khullakpa: iborncha Sorok
Moo: Robindro
Lanmee: Ningthernbir
.
Pao Puba Mee: Nimai
Thengsangba Lanrnee: Deven, Kornol
Langja: Deven, Kornol, Meera, Robin, Usha,
Sudeshkurnar
Khulgi Ahalsing: Ibochouba, Sornonbi, Nirnai,
Basanta, Shyarnsunder, Subrata, Prernananda,
Muhin, Jillasana
Dolaireng: Deven, Ninthernbir, Sornonbi, Nimai
Prologue: Ninghthernbir, Sornonoi, Basanta,
Kornol, Nirnai, Subrata, Shyamsunder, Jilla,
Muhin, Prernananda, Deven, Ibouchouba
Credits
Script, music arrangement: Ratan Thiyarn
Assistant Director: Ibochouba Meetei
Music: Inao, Juge, Deven, Kornol
Costumes: lborncha Sorok, Robindro, Binaswori
Properties; Prernananda, Nirnai, Subrata
Stage Manager: Prernananda
Assistant Stage Manager: Nimai, Subrata
Consultants: tha Dikho Mao, Ranjit Adhikari
Designed & Directed by: Ratan Thiyam

