Cast
RAMA : Jayanta Jathar
LAKSHMANA : Sandeep Jangam
SEETA : Sheetal Kashyape
RAVANA : Deepak Bhagwat
SHURPANKHA : Vaishali Renuke
AHILYA : Himani Padhye
SARASWATI : Chaitrali Dongare
SUTRADHAR : Chinmay Kelkar
VIDUSHAKA : Ajit Deshmukh
YAWANIKA HOLDERS : Sandeep Pathak , Mangesh Hadwale
ARCHAKA : Sandeep Pathak
RIDDHIâ€”SIDDHI : Bahkti Pathare, Mukta Barve
GANAPATI, RUDRAPRATAP : Akshay Pendase
BALGOPAL, GANDHARVA : Sandeep Jangam, Neeraj Borse
SHIVDATTA : Neeraj Borse
VASISTHA : Pankaj Mithbhakre
VISHVAMITRA : Pundalik Dhumal
RAJSEWAKA : C Jogdand
JANAKA : V Sahasrabuddhe
DASHARATHA : Hanmant Sargar
SAKHI : Bhakti Pathare

Credits
MUSIC : Dattaprasad Ranade
CHOREOGRAPHY : Mandar Purandare, Bhakti Pathare
MAKE-UP, COSTUMES : Chaitali Deshpande
LIGHTS : Akshay Pendase, Deepak Bhagwat, Vibhawari Dixit
MUSIC : Dattaprasad Ranade, Sameer Shivgar, Mandar Purandare,
Meghana Sahasrabuddhe, Ashwini Deshpande
COSTUME : Gandhar Chaubal, Adhriraj Deshpande, Chinmay Kelkar,
Jayant Jathar, Vaishali Runuke, Chaitrali Dongare, Bhakti Pathare, Vaibhavi
Deo, Ashwini Deshpande
PROPERTY : Mukta barve, Mangesh Hadwale
RESEARCH : Sheetal Kashyape, Sandeep Pathak, Pankaj Mithbhakre,
Jayant Jathar, Sandeep Jangam, Pundalik Dhumal, Vishwas Saharabuddhe
STAGE ASSISTANT : Himani Padhye
PRODUCTION ASSISTANT : Maithili Dhawale
PRODUCTION INCHARGE : Mangesh Hadwale

