मध्यप्रदेश नाटक लोककला अकादमी c: २ ३

भूमिका में
सूत्रधार और जटायु : राजकुमुद
नटी : उमा देराश्री

सुधाकर : राधेश्याम जोशी
भट : जयंत बहे
भरत : सोमेश अग्रवाल

प्रतीहारी : नीता जानी
कंचुकी : अश्चिनीकुमार शारुत्री
अव्रदानिका और : वीणा तिवारी

सूत : बालकृष्ण शर्मा
देवकुलिक : कैलाश शर्मा
कैकेयी : रमा श्रीवास्तव

सुमित्रा

सीता : उषाकिरण
श्रीवास्तव
चेटी : सोना विलियम्स

रावण : अजीतसिंह
वृद्ध तापस : लौकेन्द्रसिंह राठौर

राम : रफीक रवाना

तापस : विकार अहमद

लक्ष्मण : अभिलाष भट्टाचार्य
राजा : विजयेन्द्र शारुत्री

कौसल्यऊ : संध्या नरांजे
सुमंत्र : लूणकरण मंगल

नन्दिलक : भारत क्रि-बि-वाला
तापसी : बीना
सखियाँ : अलका गुर्जर
_ _ चित्रा संगमनेरकर
शत्रुघ्न : सलीम फारुकी
भरतवाक्य : श्रीनिवास रथ

प्रतिमा नाटक : निर्देशकीय वक्तव्य
मध्यप्रदेश नाटक लोककला अकादमी के "एक वर्षीय नाटक डिप्लोमा कोर्स" में

संस्कृत नाटक और संस्कूत रंगमंच का विधिवत् अध्ययन सार्थक हो सके इसलिए
कालिदास समारोह १ ९७ ८ में अकादमी द्वारा संस्कृत नाटक का मंचन विशुद्ध शास्वीय
शैली में प्रस्तुत करने का निश्चय किया गया ।
कालिदास समारोह केन्द्रीय समिति की बैठक में अकादमी के निदेशक की
' हैसियत से मैंने यह घोषणा की की इस बार कालिदास समारोह में अकादमी की ओर से
हिंदी नाटक की प्रस्तुति नहीं की जाएगी । केन्दीय समिति ने अकादमी पर यह भार दिया
कि दस बार अकादमी द्वारा संस्कृत नाटक का मूल संस्कूत में मंचन प्रस्तुत किया जाए ।

